3 24 24
XXXXXXXXXXXXXXXXXXXXXXXX
X0000000000000000000000X
X0000000000000000000000X
X000YYYYYYYYYYYYYYYY000X
X000Y00003000003000Y000X
X000Y000030M0N03000Y000X
X000Y00003000003000Y000X
X000Y000030M0N03000Y000X
X000Y00003000003000Y000X
X000Y000030M0N03000Y000X
X000YYYYYYYYYYYYYYYY000X
X000Y00003000003000Y000X
X000Y000030N0M0300AY000X
X000Y00003000003000Y000X
X000Y000030N0M03000Y000X
X000Y00003000003000Y000X
X000Y000030N0M03000Y000X
X000YYYYYYYYYYYYYYYY000X
X0000000000000000000000X
X0000000000000000000000X
X0000000000000000000000X
X0000000000000000000000X
X0000000000000000000000X
XXXXXXXX00000000XXXXXXXX
XXXXXXXXIIIIIIIIXXXXXXXX
X000000Y00000000Y000000X
X000000Y00000000Y000000X
X000000Y03030303Y000000X
X020202Y00000000Y020202X
X030000Y00000000Y000003X
X000000Y00000000Y000000X
X000300Y00000000Y000300X
X000000Y0000K000Y000000X
X000003YYYYYYYYYY030000X
X000000Y00000000Y000000X
X000000Y00000000Y000000X
X000000Y00000000Y000000X
X000003Y03030303Y030000X
X000000Y00000000Y000000X
X000300Y02020202Y000300X
X00000YY00000000YY00000X
X03000Y0000000000Y00003X
X00000Y0000000000Y00000X
X00000Y0000000000Y00000X
X00000Y0000000000Y00000X
X00000Y0000000000Y00000X
X00000X0000000000X00000X
XXXXXXX0000000000XXXXXXX
XXXXXXXIIIIIIIIIIXXXXXXX
X0000000000030000000000X
X0000000000030000000000X
X0000000000030000000000X
X00000002YYYYYY02000000X
X0000000200000002000000X
X0000020200000002020000X
X0000020200000002020000X
X00000202000K0002020000X
X000YYYYYYYYYYYYYYYY000X
X0YYY02000000000002YYY0X
XYY000020000000002000YYX
X0000002020202020200000X
X0000000000000000000000X
X0000000000000000000000X
X0101010100000001010101X
X0000000YYYYYYYY0000000X
X0000000000000000000000X
X0000000000000000000000X
X0000000000000000000000X
X0000000000000000000000X
X0000000000000000000000X
X0000000000000000000000X
XXXXXXXX00000000XXXXXXXX
10
0 12 10 U
0 2 9 U
0 11 10 U
0 21 9 U
1 9 11 U
1 4 21 U
1 14 11 U
1 19 21 U
1 2 2 U
1 9 7 U
1 21 2 U
1 14 7 U
2 2 2 U
2 17 15 U
2 21 2 U
2 6 15 U
2 3 21 U
2 17 6 U
2 20 21 U
2 6 6 U