3 24 24
XXXXXXXXXXXXXXXXXXXXXXXX
X0000000000000000000000X
X0000000000000000000000X
X00N0M0000000000000M0N0X
X000000000N000M00000000X
X0000000001010100000000X
X0000000010000010000000X
X0N0M0N00010101000M0N0MX
X0000000000000000000000X
X0M0N0MY0000000AY0N0M0NX
XYYYYYYY01010101YYYYYYYX
X0000000000000000000000X
X0000000000000000000000X
X0000000000000000000000X
X0000000010101010000000X
X0000000000000000000000X
X0001010100000000101010X
X0000000000000000000000X
X0000000010101010000000X
X0000000000000000000000X
X0000000000000000000000X
X0000000000000000000000X
X0000000000000000000000X
XXXXXXXX00000000XXXXXXXX
XXXXXXXXIIIIIIIIXXXXXXXX
X0000000000000000000000X
X0000000000000000000000X
X0000001001001001000000X
X0000000000000000000000X
X0001001001001001001000X
X0000000000000000000000X
X0000001001001001000000X
X0000000000000000000000X
X0000000000000000000000X
X00000000000K0000000000X
X010101YYYYYYYYYY010101X
X0101010100000001010101X
X0000000000000000000000X
X0000010101010101010000X
X0000000000000000000000X
X0000000000000000000000X
X0000000000000000000000X
X0000000000000000000000X
X0000000000000000000000X
X0000000000000000000000X
X0000000000000000000000X
X0000000000000000000000X
XXXXXXXX00000000XXXXXXXX
XXXXXXXXIIIIIIIIXXXXXXXX
X0000000000000000000000X
X0000000000000000000000X
X0000000000000000000000X
X00000000000K0000000000X
X0000000000000000000000X
X0000000000000000000000X
X0000010101010101010000X
X0000100000101000001000X
X0001010101010101010100X
XYYYYYY0000101000YYYYYYX
X0001010101010101010100X
X0000100000101000001000X
X0000010101010101010000X
X0000000000000000000000X
X0000000000000000000000X
X0000000000000000000000X
X0000000000000000000000X
X0000000000000000000000X
X0000000000000000000000X
X0000000000000000000000X
X0000000000000000000000X
X0000000000000000000000X
XXXXXXXX00000000XXXXXXXX
0