3 24 24
XXXXXXXXXXXXXXXXXXXXXXXX
X0000000000000000000000X
X0000000000000000000000X
X000YYYYYYYYYYYYYYYY000X
X000Y00030003000300Y000X
X000Y00030N030N0300Y000X
X000Y00030003000300Y000X
X000Y00030M030N0300Y000X
X000Y00030003000300Y000X
X000Y00030M030N0300Y000X
X000YYYYYYYYYYYYYYYY000X
X000Y00030003000300Y000X
X000Y00030N030M0300Y000X
X000Y00030003000300Y000X
X000Y00030N030M0300Y000X
X000Y00030003000300Y000X
X000Y00030N030M0300Y000X
X000YYYYYYYYYYYYYYYY000X
X0000000000000000000000X
X0000000000000000000000X
X0000000000000000000000X
X0000000000000000000000X
X0000000000000000000000X
XXXXXXXX00000000XXXXXXXX
XXXXXXXXIIIIIIIIXXXXXXXX
X000000Y00000000Y000000X
X000000Y00000000Y000000X
X020202Y03030303Y020202X
X000000Y00000000Y000000X
X030000Y00000000Y000003X
X000000Y00000000Y000000X
X000300Y00000000Y000300X
X000000Y00000000Y000000X
X000003YYYYYYYYYY030000X
X000000Y00000000Y000000X
X000000Y00000000Y000000X
X000000Y00000000Y000000X
X000003Y03030303Y030000X
X000000Y00000000Y000000X
X000300Y02020202Y000300X
X00000YY00000000YY00000X
X03000Y0000000000Y00003X
X00000Y0000000000Y00000X
X00000Y0000000000Y00000X
X00000Y0000000000Y00000X
X00000Y0000000000Y00000X
X00000Y0000000000Y00000X
XXXXXXX0000000000XXXXXXX
XXXXXXXIIIIIIIIIIXXXXXXX
X0000000000030000000000X
X0000000000030000000000X
X0000000000030000000000X
X00000002YYYYYY02000000X
X0000000200000002000000X
X0000020200000002020000X
X0000020200000002020000X
X00000202000K0002020000X
X000YYYYYYYYYYYYYYYY000X
X0YYY02000000000002YYY0X
XYY000020000000002000YYX
X0000002020202020200000X
X0000000000000000000000X
X0000000000000000000000X
X0101010100000001010101X
X0000000YYYYYYYY0000000X
X0000000000000000000000X
X0000000000000000000000X
X0000000000000000000000X
X0000000000000000000000X
X0000000000000000000000X
X0000000000000000000000X
XXXXXXXX00000000XXXXXXXX
10
0 12 10 U
0 2 9 U
0 11 10 U
0 21 9 U
1 8 10 U
1 5 22 U
1 15 10 U
1 18 22 U
1 1 1 U
1 8 8 U
1 22 1 U
1 15 8 U
2 1 1 U
2 18 16 U
2 22 1 U
2 5 16 U
2 1 22 U
2 18 4 U
2 22 22 U
2 5 4 U