3 24 24
XXXXXXXXXXXXXXXXXXXXXXXX
X0000000000000000000000X
X0000000000000000000000X
X000YYYYYYYYYYYYYYYY000X
X000Y00000000000000Y000X
X000Y00000000000000Y000X
X000Y00000000000000Y000X
X000Y00000000000000Y000X
X000Y00000000000000Y000X
X000Y00000000000000Y000X
X000YYYYYYYYYYYYYYYY000X
X000Y00000000000000Y000X
X000Y00000000000000Y000X
X000Y00000000000000Y000X
X000Y00000000000000Y000X
X000Y00000000000000Y000X
X000Y00000000000000Y000X
X000YYYYYYYYYYYYYYYY000X
X0000000000000000000000X
X0000000000000000000000X
X0000000000000000000000X
X0000000000000000000000X
X0000000000000000000000X
XXXXXXXX00000000XXXXXXXX
XXXXXXXXIIIIIIIIXXXXXXXX
X000000Y00000000Y000000X
X000000Y00000000Y000000X
X000000Y00000000Y000000X
X000000Y00000000Y000000X
X000000Y00000000Y000000X
X000000Y00000000Y000000X
X000000Y00000000Y000000X
X000000Y00000000Y000000X
X000000YYYYYYYYYY000000X
X000000Y00000000Y000000X
X000000Y00000000Y000000X
X000000Y00000000Y000000X
X000000Y00000000Y000000X
X000000Y00000000Y000000X
X000000Y00000000Y000000X
X00000YY00000000YY00000X
X00000Y0000000000Y00000X
X00000Y0000000000Y00000X
X00000Y0000000000Y00000X
X00000Y0000000000Y00000X
X00000Y0000000000Y00000X
X00000Y0000000000Y00000X
XXXXXXX0000000000XXXXXXX
XXXXXXXIIIIIIIIIIXXXXXXX
X0000000000000000000000X
X0000000000000000000000X
X0000000000000000000000X
X00000000YYYYYY00000000X
X0000000000000000000000X
X0000000000000000000000X
X0000000000000000000000X
X0000000000000000000000X
X000YYYYYYYYYYYYYYYY000X
X0YYY00000000000000YYY0X
XYY000000000000000000YYX
X0000000000000000000000X
X0000000000000000000000X
X0000000000000000000000X
X0000000000000000000000X
X0000000YYYYYYYY0000000X
X0000000000000000000000X
X0000000000000000000000X
X0000000000000000000000X
X0000000000000000000000X
X0000000000000000000000X
X0000000000000000000000X
XXXXXXXX00000000XXXXXXXX
0