TILEMAP
24 72 							-- Size of tile map in tiles
16 16 							-- Tile size & block size
images/tileset_1.png 	-- Tilesheet
4 3 								-- Number of tiles in tilesheet
12							-- Tile that is the border block
12 12 12 12 12 12 12 12 12 12 12 12 12 12 12 12 12 12 12 12 12 12 12 12 
12 9 10 9 9 9 9 9 9 9 9 9 9 9 9 9 9 9 9 9 9 10 9 12 
12 10 9 10 9 9 9 9 9 9 9 9 9 9 9 9 9 9 9 9 10 9 10 12 
12 9 10 9 12 12 12 12 12 12 12 12 12 12 12 12 12 12 12 12 9 10 9 12 
12 9 9 9 12 9 9 9 9 9 9 9 9 9 9 9 9 9 9 12 9 9 9 12 
12 9 9 9 12 9 9 9 9 9 9 9 9 9 9 9 9 9 9 12 9 9 9 12 
12 9 9 9 12 9 9 9 11 11 11 11 11 11 11 11 9 9 9 12 9 9 9 12 
12 9 9 9 12 9 9 9 11 11 11 11 11 11 11 11 9 9 9 12 9 9 9 12 
12 9 9 9 12 9 9 9 9 9 9 9 9 9 9 9 9 9 9 12 9 9 9 12 
12 9 9 9 12 9 9 9 9 9 9 9 9 9 9 9 9 9 9 12 9 9 9 12 
12 9 9 9 12 12 12 12 12 12 12 12 12 12 12 12 12 12 12 12 9 9 9 12 
12 9 9 9 12 9 9 9 9 9 9 9 9 9 9 9 9 9 9 12 9 9 9 12 
12 9 9 9 12 9 9 9 9 9 9 9 9 9 9 9 9 9 9 12 9 9 9 12 
12 9 9 9 12 9 9 9 10 10 10 10 10 10 10 10 9 9 9 12 9 9 9 12 
12 9 9 9 12 9 9 9 10 10 10 10 10 10 10 10 9 9 9 12 9 9 9 12 
12 9 9 9 12 9 9 9 9 9 9 9 9 9 9 9 9 9 9 12 9 9 9 12 
12 9 9 9 12 9 9 9 9 9 9 9 9 9 9 9 9 9 9 12 9 9 9 12 
12 9 9 9 12 12 12 12 12 12 12 12 12 12 12 12 12 12 12 12 9 9 9 12 
12 9 9 9 9 9 9 9 9 9 9 9 9 9 9 9 9 9 9 9 9 9 9 12 
12 9 9 10 9 10 9 9 9 9 9 9 9 9 9 9 9 9 11 9 11 9 9 12 
12 9 9 9 10 9 9 9 9 9 9 9 9 9 9 9 9 9 9 11 9 9 9 12 
12 9 9 10 9 10 9 9 9 9 9 9 9 9 9 9 9 9 11 9 11 9 9 12 
12 9 9 9 10 9 9 9 9 9 9 9 9 9 9 9 9 9 9 11 9 9 9 12 
12 12 12 12 12 12 12 12 9 9 9 9 9 9 9 9 12 12 12 12 12 12 12 12 
12 12 12 12 12 12 12 12 9 9 9 9 9 9 9 9 12 12 12 12 12 12 12 12 
12 9 9 9 9 9 9 12 9 9 9 9 9 9 9 9 12 9 9 9 9 9 9 12 
12 9 10 10 10 10 9 12 9 9 9 9 9 9 9 9 12 9 10 10 10 10 9 12 
12 9 10 9 9 10 9 12 9 9 9 9 9 9 9 9 12 9 10 9 9 10 9 12 
12 9 10 9 9 10 9 12 9 9 9 9 9 9 9 9 12 9 10 9 9 10 9 12 
12 9 10 9 9 10 9 12 9 9 9 9 9 9 9 9 12 9 10 10 10 10 9 12 
12 9 10 9 9 10 9 12 9 9 9 9 9 9 9 9 12 9 10 9 9 10 9 12 
12 9 10 9 9 10 9 12 9 9 9 9 9 9 9 9 12 9 10 10 10 10 9 12 
12 9 10 9 9 10 9 12 9 9 9 9 9 9 9 9 12 9 10 9 9 10 9 12 
12 9 10 9 9 10 9 12 12 12 12 12 12 12 12 12 12 9 10 10 10 10 9 12 
12 9 10 9 9 10 9 12 9 9 9 9 9 9 9 9 12 9 10 9 9 10 9 12 
12 9 10 9 9 10 9 12 9 9 9 9 9 9 9 9 12 9 10 10 10 10 9 12 
12 9 10 9 9 10 9 12 9 9 9 9 9 9 9 9 12 9 10 9 9 10 9 12 
12 9 10 9 9 10 9 12 9 9 9 9 9 9 9 9 12 9 10 9 9 10 9 12 
12 9 10 10 10 10 9 12 9 9 9 9 9 9 9 9 12 9 10 10 10 10 9 12 
12 9 9 9 9 9 9 12 9 9 11 9 9 11 9 9 12 9 9 9 9 9 9 12 
12 9 9 9 9 9 12 12 9 11 11 9 9 11 11 9 12 12 9 9 9 9 9 12 
12 9 9 9 9 9 12 9 9 9 9 11 11 9 9 9 9 12 9 9 9 9 9 12 
12 9 9 9 9 9 12 9 9 9 9 11 11 9 9 9 9 12 9 9 9 9 9 12 
12 9 9 9 9 9 12 9 9 11 11 9 9 11 11 9 9 12 9 9 9 9 9 12 
12 9 9 9 9 9 12 9 9 9 11 9 9 11 9 9 9 12 9 9 9 9 9 12 
12 9 9 9 9 9 12 9 9 9 9 9 9 9 9 9 9 12 9 9 9 9 9 12 
12 9 9 9 9 9 12 9 9 9 9 9 9 9 9 9 9 12 9 9 9 9 9 12 
12 12 12 12 12 12 12 9 9 9 9 9 9 9 9 9 9 12 12 12 12 12 12 12 
12 12 12 12 12 12 12 9 9 9 9 9 9 9 9 9 9 12 12 12 12 12 12 12 
12 9 10 9 9 9 9 9 9 9 9 9 9 9 9 9 9 9 9 9 9 10 9 12 
12 10 9 9 9 9 9 9 9 9 9 9 9 9 9 9 9 9 9 9 9 9 10 12 
12 9 9 9 9 9 9 9 9 9 9 9 9 9 9 9 9 9 9 9 9 9 9 12 
12 9 9 9 9 9 9 9 9 12 12 12 12 12 12 9 9 9 9 9 9 9 9 12 
12 9 9 9 9 9 9 9 10 9 10 9 9 10 9 10 9 9 9 9 9 9 9 12 
12 9 9 9 9 9 9 9 9 11 9 11 11 9 11 9 9 9 9 9 9 9 9 12 
12 9 9 9 9 9 9 9 9 11 9 11 11 9 11 9 9 9 9 9 9 9 9 12 
12 9 9 9 9 9 9 9 10 9 10 9 9 10 9 10 9 9 9 9 9 9 9 12 
12 9 9 9 12 12 12 12 12 12 12 12 12 12 12 12 12 12 12 12 9 9 9 12 
12 9 12 12 12 9 9 9 9 9 9 9 9 9 9 9 9 9 9 12 12 12 9 12 
12 12 12 9 9 9 9 9 9 9 9 9 9 9 9 9 9 9 9 9 9 12 12 12 
12 9 9 9 9 9 9 9 9 9 9 9 9 9 9 9 9 9 9 9 9 9 9 12 
12 9 9 10 9 9 9 9 9 9 9 9 9 9 9 9 9 9 9 9 11 9 9 12 
12 9 10 9 10 9 9 9 9 9 9 9 9 9 9 9 9 9 9 11 9 11 9 12 
12 10 9 9 9 10 9 9 9 9 9 9 9 9 9 9 9 9 11 9 9 9 11 12 
12 9 10 9 10 9 9 9 12 12 12 12 12 12 12 12 9 9 9 11 9 11 9 12 
12 9 9 10 9 9 9 9 9 9 9 9 9 9 9 9 9 9 9 9 11 9 9 12 
12 9 9 9 9 9 9 9 9 9 9 9 9 9 9 9 9 9 9 9 9 9 9 12 
12 9 9 9 9 9 9 9 9 9 9 9 9 9 9 9 9 9 9 9 9 9 9 12 
12 9 9 9 9 9 9 9 9 9 9 9 9 9 9 9 9 9 9 9 9 9 9 12 
12 9 9 9 9 9 9 9 9 9 9 9 9 9 9 9 9 9 9 9 9 9 9 12 
12 9 9 9 9 9 9 9 9 9 9 9 9 9 9 9 9 9 9 9 9 9 9 12 
12 12 12 12 12 12 12 12 9 9 9 9 9 9 9 9 12 12 12 12 12 12 12 12