3 24 24
XXXXXXXXXXXXXXXXXXXXXXXX
X0000000000000000000000X
X0000000000000000000000X
X0000000000000000000000X
X0000000000000000000000X
X0000000000000000000000X
X0000000000000000000000X
X0000000000000000000000X
X0000000000000000000000X
X0000000000000000000000X
X0000000000000000000000X
X0000000000000000000000X
XYYYYYYYYYYYYYYYYYYYYYYX
X0000000000000000000000X
X0000000000000000000000X
X0000000000000000000000X
X0000000000000000000000X
X0000000000000000000000X
X0000000000000000000000X
X0000000000000000000000X
X0000000000000000000000X
X0000000000000000000000X
X0000000000000000000000X
XXXXXXXX00000000XXXXXXXX
XXXXXXXXIIIIIIIIXXXXXXXX
X0000000000000000000000X
X0000000000000000000000X
X0000000000000000000000X
X0000000000000000000000X
X00000000000K0000000000X
X020202YYYYYYYYYY020202X
X0000020000000000020000X
XY00000200000000020000YX
XYY000002000000020000YYX
X0YY0000020000020000YY0X
X00YY00000200020000YY00X
X000YY000002020000YY000X
X0000YY0001000100YY0000X
X00000YY01010101YY00000X
X0000000000000000000000X
X0000000000000000000000X
X0000000000000000000000X
X0000000000000000000000X
X0000000000000000000000X
X0000000000000000000000X
X0000000000000000000000X
X0000000000000000000000X
XXXXXXXX00000000XXXXXXXX
XXXXXXXXIIIIIIIIXXXXXXXX
X0000000000000000000000X
X0000000000000000000000X
X0200000000000000000002X
X00202Y0101010101Y02020X
X00000Y0000000000Y00000X
X00000Y00000K0000Y00000X
X00000Y000YYYY000Y00000X
X00000Y0101010101Y00000X
X00000Y0001000100Y00000X
X00000Y0010000010Y00000X
X00000Y0100000001Y00000X
X00000Y0000000000Y00000X
X0000000000000000000000X
X0000000000000000000000X
X0000000000000000000000X
X0000000000000000000000X
X0000000000000000000000X
X0000000000000000000000X
X0000000000000000000000X
X0000000000000000000000X
X0000000000000000000000X
X0000000000000000000000X
XXXXXXXX00000000XXXXXXXX
0