3 24 24
XXXXXXXXXXXXXXXXXXXXXXXX
X0000000002000200000000X
X000000000200020000000NX
X0000000002000200000000X
X0000000N0200020N000000X
X0202020202000202020202X
X0200000000000000000002X
X00000000000A0000000000X
X0000000N0000000N000000X
X0202000000000000000202X
X0002000000000000000200X
X0N0200000000000000020NX
XYYYYYYYYYYYYYYYYYYYYYYX
X0000000000000000000000X
X0M0000000000000000000MX
X0000000000000000000000X
X0000000M0000000M000000X
X0000000000000000000000X
X0000000000000000000000X
X0202020000000000020202X
X0000020000000000020000X
X0000020000000000020000X
X0M0002X00000000X02000MX
XXXXXXXX00000000XXXXXXXX
XXXXXXXXIIIIIIIIXXXXXXXX
X0000000000000000000000X
X0000000000000000000000X
X000000202020202020000AX
X0000200000000000002000X
X02020200000K0000020202X
X020202YYYYYYYYYY020202X
X0000020000000000020000X
XY00000200000000020000YX
XYY000002000000020000YYX
X0Y000000200000200000Y0X
X0YY0000002000200000YY0X
X00YY00000020200000YY00X
XYYYYYYY00100010YYYYYYYX
X0000000010101010000000X
X0000000000000000000000X
X0000000000000000000000X
X0000000000000000000000X
X0000000000000000000000X
X0000000000000000000000X
X0000000000000000000000X
X0000000000000000000000X
X0000000000000000000000X
XXXXXXXX00000000XXXXXXXX
XXXXXXXXIIIIIIIIXXXXXXXX
X0000000000000000000000X
X0000000000000000000000X
X0200000000000000000002X
X00202Y0202020202Y02020X
X00000Y0000000000Y00000X
X00000Y02000K0020Y00000X
X00000Y002YYYY002Y00000X
X00000Y0101010101Y00000X
X00000Y0001000100Y00000X
X00000Y0010000010Y00000X
X00000Y0100000001Y00000X
X00000Y0000000000Y00000X
X0000000000000000000000X
X0000000000000000000000X
X0000000000000000000000X
X0000000000000000000000X
X0000000000000000000000X
X0000000000000000000000X
X0000000000000000000000X
X0000000000000000000000X
X0000000000000000000000X
X0000000000000000000000X
XXXXXXXX00000000XXXXXXXX
2
2 19 4 U
2 4 20 U
2 19 20 U
2 4 4 U 