TILEMAP
24 72 							-- Size of tile map in tiles
16 16 							-- Tile size & block size
images/tileset_1.png 	-- Tilesheet
4 3 								-- Number of tiles in tilesheet
8							-- Tile that is the border block
8 8 8 8 8 8 8 8 8 8 8 8 8 8 8 8 8 8 8 8 8 8 8 8 
8 6 5 5 5 5 5 5 5 7 7 7 7 7 7 5 5 5 5 5 5 5 6 8 
8 6 6 5 5 5 5 5 5 5 5 5 5 5 5 5 5 5 5 5 5 6 6 8 
8 5 6 6 5 5 5 5 5 5 5 5 5 5 5 5 5 5 5 5 6 6 5 8 
8 5 5 6 6 5 5 5 5 5 5 5 5 5 5 5 5 5 5 6 6 5 5 8 
8 5 5 5 6 6 5 5 5 5 5 5 5 5 5 5 5 5 6 6 5 5 5 8 
8 5 5 5 5 6 6 5 5 5 5 5 5 5 5 5 5 6 6 5 5 5 5 8 
8 5 5 5 5 5 6 6 5 5 5 5 5 5 5 5 6 6 5 5 5 5 5 8 
8 7 5 5 5 5 5 6 6 6 6 6 6 6 6 6 6 5 5 5 5 5 7 8 
8 5 7 5 5 5 5 6 5 5 5 5 5 5 5 5 6 5 5 5 5 7 5 8 
8 7 5 7 5 5 5 6 5 5 5 5 5 5 5 5 6 5 5 5 7 5 7 8 
8 5 7 5 7 5 5 6 5 5 5 5 5 5 5 5 6 5 5 7 5 7 5 8 
8 8 8 8 8 8 8 8 8 8 8 8 8 8 8 8 8 8 8 8 8 8 8 8 
8 5 7 5 7 5 5 6 5 5 5 5 5 5 5 5 6 5 5 7 5 7 5 8 
8 7 5 7 5 5 5 6 5 5 5 5 5 5 5 5 6 5 5 5 7 5 7 8 
8 5 7 5 5 5 5 6 5 5 5 5 5 5 5 5 6 5 5 5 5 7 5 8 
8 7 5 5 5 5 5 6 6 6 6 6 6 6 6 6 6 5 5 5 5 5 7 8 
8 5 5 5 5 5 6 6 5 5 5 5 5 5 5 5 6 6 5 5 5 5 5 8 
8 5 5 5 5 6 6 5 5 5 5 5 5 5 5 5 5 6 6 5 5 5 5 8 
8 5 5 5 6 6 5 5 5 5 5 5 5 5 5 5 5 5 6 6 5 5 5 8 
8 5 5 6 6 5 5 5 5 5 5 5 5 5 5 5 5 5 5 6 6 5 5 8 
8 5 6 6 5 5 5 5 5 5 5 5 5 5 5 5 5 5 5 5 6 6 5 8 
8 6 6 5 5 5 5 8 5 5 5 5 5 5 5 5 8 5 5 5 5 6 6 8 
8 8 8 8 8 8 8 8 5 5 5 5 5 5 5 5 8 8 8 8 8 8 8 8 
8 8 8 8 8 8 8 8 5 5 5 5 5 5 5 5 8 8 8 8 8 8 8 8 
8 7 7 7 5 5 5 5 5 5 5 5 5 5 5 5 5 5 5 5 7 7 7 8 
8 5 7 7 5 5 5 5 5 5 5 5 5 5 5 5 5 5 5 5 7 7 5 8 
8 7 5 7 5 5 5 5 5 5 5 5 5 5 5 5 5 5 5 5 7 5 7 8 
8 5 5 5 5 5 5 5 5 5 5 5 5 5 5 5 5 5 5 5 5 5 5 8 
8 5 5 5 5 5 5 5 5 5 5 5 5 5 5 5 5 5 5 5 5 5 5 8 
8 5 5 5 5 5 5 8 8 8 8 8 8 8 8 8 8 5 5 5 5 5 5 8 
8 5 5 5 5 5 5 5 5 5 5 5 5 5 5 5 5 5 5 5 5 5 5 8 
8 8 5 5 5 5 5 6 6 6 6 6 6 6 6 6 6 5 5 5 5 5 8 8 
8 8 8 5 5 5 5 6 6 5 5 5 5 5 5 6 6 5 5 5 5 8 8 8 
8 6 8 5 5 5 5 5 6 6 5 5 5 5 6 6 5 5 5 5 5 8 6 8 
8 6 8 8 5 5 5 5 5 6 6 5 5 6 6 5 5 5 5 5 8 8 6 8 
8 6 6 8 8 5 5 5 5 5 6 6 6 6 5 5 5 5 5 8 8 6 6 8 
8 8 8 8 8 8 8 8 5 5 5 6 6 5 5 5 8 8 8 8 8 8 8 8 
8 5 5 5 5 5 5 5 5 5 5 5 5 5 5 5 5 5 5 5 5 5 5 8 
8 5 5 5 5 5 5 5 5 5 5 5 5 5 5 5 5 5 5 5 5 5 5 8 
8 5 5 5 5 5 5 5 5 5 5 5 5 5 5 5 5 5 5 5 5 5 5 8 
8 5 5 5 5 5 5 5 5 5 5 5 5 5 5 5 5 5 5 5 5 5 5 8 
8 5 5 5 5 5 5 5 5 5 5 5 5 5 5 5 5 5 5 5 5 5 5 8 
8 5 5 5 5 5 5 5 5 5 5 5 5 5 5 5 5 5 5 5 5 5 5 8 
8 7 7 7 5 5 5 5 5 5 5 5 5 5 5 5 5 5 5 5 7 7 7 8 
8 5 7 7 5 5 5 5 5 5 5 5 5 5 5 5 5 5 5 5 7 7 5 8 
8 7 5 7 5 5 5 5 5 5 5 5 5 5 5 5 5 5 5 5 7 5 7 8 
8 8 8 8 8 8 8 8 5 5 5 5 5 5 5 5 8 8 8 8 8 8 8 8 
8 8 8 8 8 8 8 8 5 5 5 5 5 5 5 5 8 8 8 8 8 8 8 8 
8 7 7 5 5 5 5 5 5 5 5 5 5 5 5 5 5 5 5 5 5 7 7 8 
8 7 7 5 5 5 5 5 5 5 5 5 5 5 5 5 5 5 5 5 5 7 7 8 
8 5 5 5 5 5 5 5 6 6 6 6 6 6 6 6 5 5 5 5 5 5 5 8 
8 5 5 5 5 5 8 5 5 5 5 5 5 5 5 5 5 8 5 5 5 5 5 8 
8 5 5 5 5 5 8 5 5 5 5 5 5 5 5 5 5 8 5 5 5 5 5 8 
8 5 5 5 5 5 8 5 5 5 5 5 5 5 5 5 5 8 5 5 5 5 5 8 
8 5 5 5 5 5 8 5 5 5 8 8 8 8 5 5 5 8 5 5 5 5 5 8 
8 5 5 5 5 5 8 5 5 5 5 5 5 5 5 5 5 8 5 5 5 5 5 8 
8 5 5 5 5 5 8 5 5 5 6 5 5 6 5 5 5 8 5 5 5 5 5 8 
8 5 5 5 5 5 8 5 5 5 6 5 5 6 5 5 5 8 5 5 5 5 5 8 
8 5 5 5 5 5 8 5 5 5 5 5 5 5 5 5 5 8 5 5 5 5 5 8 
8 5 5 5 5 5 8 5 5 5 5 5 5 5 5 5 5 8 5 5 5 5 5 8 
8 5 5 5 5 5 5 5 5 5 5 5 5 5 5 5 5 5 5 5 5 5 5 8 
8 5 5 5 5 5 5 5 5 5 5 5 5 5 5 5 5 5 5 5 5 5 5 8 
8 5 5 5 5 5 6 6 6 5 5 5 5 5 5 6 6 6 5 5 5 5 5 8 
8 5 5 5 5 5 6 6 5 5 5 5 5 5 5 5 6 6 5 5 5 5 5 8 
8 5 5 5 5 5 5 5 5 5 5 5 5 5 5 5 5 5 5 5 5 5 5 8 
8 5 5 5 5 5 5 5 5 5 5 5 5 5 5 5 5 5 5 5 5 5 5 8 
8 5 5 5 5 5 5 5 5 5 5 5 5 5 5 5 5 5 5 5 5 5 5 8 
8 5 5 5 5 5 5 5 5 5 5 5 5 5 5 5 5 5 5 5 5 5 5 8 
8 7 7 5 5 5 5 5 5 5 5 5 5 5 5 5 5 5 5 5 5 7 7 8 
8 7 7 5 5 5 5 5 5 5 5 5 5 5 5 5 5 5 5 5 5 7 7 8 
8 8 8 8 8 8 8 8 5 5 5 5 5 5 5 5 8 8 8 8 8 8 8 8