TILEMAP
24 24 							-- Size of tile map in tiles
16 16 							-- Tile size & block size
images/tileset_1.png 	-- Tilesheet
4 3 								-- Number of tiles in tilesheet
1 2 3 4 5 6 7 8 9 10 11 12 0 0 0 0 0 0 0 0 0 0 0 0 
0 0 0 0 0 0 0 0 0 0 0 0 0 0 0 0 0 0 13 0 0 0 0 0 
1 2 3 4 0 0 0 0 0 0 0 0 0 0 0 0 0 13 13 0 0 0 0 0 
5 6 7 8 0 0 0 0 0 6 6 6 6 6 6 6 13 13 0 13 0 0 0 0 
9 10 11 12 0 0 0 0 0 6 0 0 0 0 13 13 13 0 0 13 0 0 0 0 
0 0 0 0 0 0 13 13 13 13 0 0 7 13 13 0 6 0 0 0 13 0 0 0 
0 0 0 0 0 0 13 0 6 13 13 13 13 13 7 7 7 6 0 0 13 0 0 0 
0 0 0 0 0 10 13 6 6 0 6 7 6 6 0 0 7 7 0 0 13 0 0 0 
0 0 0 0 10 10 13 6 6 10 6 7 0 6 6 0 0 7 7 0 13 0 0 0 
0 0 0 0 10 0 13 0 6 0 0 7 0 7 7 6 6 0 7 0 0 0 0 0 
10 0 0 0 10 0 13 0 6 0 0 7 7 0 7 0 6 6 7 7 0 0 0 0 
10 10 10 10 10 0 13 0 6 6 10 10 7 6 7 0 0 6 6 7 0 0 0 0 
0 0 0 10 10 10 10 10 10 6 6 10 0 7 7 0 0 0 6 7 0 0 13 0 
0 0 0 0 10 10 0 0 0 10 6 6 10 0 0 6 6 6 6 7 0 0 0 0 
0 0 0 0 0 10 10 0 10 10 0 6 6 0 6 0 0 0 0 7 0 0 0 0 
0 0 0 0 0 5 10 10 10 5 5 0 6 6 6 0 0 0 0 0 5 5 0 0 
0 0 0 0 0 11 0 5 5 0 0 5 5 10 10 0 0 0 5 5 5 0 0 0 
0 0 0 0 0 11 11 0 0 0 0 11 11 5 10 10 10 5 5 0 0 5 0 0 
0 0 0 0 0 0 11 0 0 0 11 11 0 0 5 5 5 5 0 0 0 5 0 0 
0 0 0 0 0 0 11 0 11 11 11 0 0 0 0 5 5 0 0 0 0 5 0 0 
0 0 0 0 11 11 11 11 11 11 0 0 0 0 0 0 5 0 0 0 0 5 0 0 
0 0 0 11 11 11 11 11 0 0 0 0 0 0 0 0 5 5 0 0 0 5 0 0 
0 0 0 11 11 11 0 0 0 0 0 0 0 0 0 0 5 5 0 0 0 5 0 0 
0 0 0 0 0 0 0 0 0 0 0 0 0 0 0 0 0 0 0 0 0 5 0 0