3 24 24
XXXXXXXXIIIIIIIIXXXXXXXX
X0000000000000000000000X
X0000000000000000000000X
X0000000000000000000000X
X0000000000000000000000X
X0000000000000000000000X
X0001020300000000000000X
X0001020300000000000000X
X0000000000000000000000X
X0000000000000000000000X
X0000000000000000000000X
X0000000000000000000000X
X0000000000000000000000X
X0000000000000000000000X
X00000000M0000000000000X
X000000000M000000000000X
X0000000N0N000000000000X
X0000000000000000000000X
X0000000000000000000000X
X0000000000000000000000X
X0000000000000000000000X
X0000000000000000000000X
X0000000000000000000000X
XXXXXXXX00000000XXXXXXXX
XXXXXXXXIIIIIIIIXXXXXXXX
X0000000000000000000000X
X0000000000000000000000X
X0000000000000000000000X
X0000000000000000000000X
X0000000000000000000000X
X0000000000000000000000X
X0000000000000000000000X
X0000000000000000000000X
X0000000000000000000000X
X0000000000000000000000X
X0000000000000000000000X
X0000000000000000000000X
X0000000000000000000000X
X0000000000000000000000X
X0000000000000000000000X
X0000000000000000000000X
X0000000000000000000000X
X0000000000000000000000X
X0000000000000000000000X
X0000000000000000000000X
X0000000000000000000000X
X0000000000000000000000X
XXXXXXXX00000000XXXXXXXX
XXXXXXXXIIIIIIIIXXXXXXXX
X0000000000000000000000X
X0000000000000000000000X
X0000000000000000000000X
X0000000000000000000000X
X0000000000000000000000X
X0000000000000000000000X
X0000000000000000000000X
X0000000000000000000000X
X0000000000000000000000X
X0000000000000000000000X
X0000000000000000000000X
X0000000000000000000000X
X0000000000000000000000X
X0000000000000000000000X
X0000000000000000000000X
X0000000000000000000000X
X0000000000000000000000X
X0000000000000000000000X
X0000000000000000000000X
X0000000000000000000000X
X0000000000000000000000X
X0000000000000000000000X
XXXXXXXX00000000XXXXXXXX