3 24 24
XXXXXXXXXXXXXXXXXXXXXXXX
X0000000000000000000000X
X0000000000000000000000X
X00N0M0000000000000N0M0X
X000000000N00M000000000X
X0000000001010100000000X
X0000000010000010000000X
X0N0M0N00010101000M0N0MX
X0000000000000000000000X
X0M0N0MX00000000X0N0M0NX
XXXXXXXX01010101XXXXXXXX
X0X0X00000000000000X0X0X
X0000000000000000000000X
X0M0N000000000000000M0NX
X0000000010101010000000X
XN00000000000000000000MX
X0001010100000000101010X
X0000000000000000000000X
X0000000010101010000000X
X0000000000000000000000X
X0000000000000000000000X
X0000000000000000000000X
X0000000000000000000000X
XXXXXXXX00000000XXXXXXXX
XXXXXXXXIIIIIIIIXXXXXXXX
X0000000000000000000000X
X0000000000000000000000X
X0000000000000000000000X
X0000000000000000000000X
X0000000000000000000000X
X0000000000000000000000X
X0000000000000000000000X
X0000000000000000000000X
X0000000000000000000000X
X0000000000000000000000X
X0000000000000000000000X
X0000000000000000000000X
X0000000000000000000000X
X0000000000000000000000X
X0000000000000000000000X
X0000000000000000000000X
X0000000000000000000000X
X0000000000000000000000X
X0000000000000000000000X
X0000000000000000000000X
X0000000000000000000000X
X0000000000000000000000X
XXXXXXXX00000000XXXXXXXX
XXXXXXXXIIIIIIIIXXXXXXXX
X0000000000000000000000X
X0000000000000000000000X
X0000000000000000000000X
X0000000000000000000000X
X0000000000000000000000X
X0000000000000000000000X
X0000000000000000000000X
X0000000000000000000000X
X0000000000000000000000X
X0000000000000000000000X
X0000000000000000000000X
X0000000000000000000000X
X0000000000000000000000X
X0000000000000000000000X
X0000000000000000000000X
X0000000000000000000000X
X0000000000000000000000X
X0000000000000000000000X
X0000000000000000000000X
X0000000000000000000000X
X0000000000000000000000X
X0000000000000000000000X
XXXXXXXX00000000XXXXXXXX